11111111111111111111111111111
1                           1
1                           1
1                           1
1                           1
1                           1
1                           1
1            111            1
1            1E1            1
1           11L11           1
1           1C C1           1
1           1   1           1
1           1   1           1
1         111B11111         1
1         1y  1  b1         1
1         1   1   1         1
1         1C  1  C1         1
1       111B1R1Y1R111       1
1       1C  1   1  C1       1
1       1   1   1   1       1
1       1y  1bPr1  g1       1
1     11111Y11111G11111     1
1     1r  1  r1C  1  C1     1
1     1   1   1   1   1     1
1     1   G  C1C  R   1     1
1     11111111111111111     1
1                           1
1                           1
1                           1
1                           1
11111111111111111111111111111
