11111111111111111111111111111
1                           1
1                           1
1                           1
1                           1
1         111111111111      1
1         1v<<< >>>>v1      1
1         1v111^1   v1      1
1         1v161^1   v1      1
1       111v1v1^1 i v1      1
1       1E2     11i1v1      1
1       111       i  1      1
1       1C>  P    i  111    1
1     11111       iiiiJ1    1
1     1Kiii       iiJCi1    1
1    11i  1^1i1^1 iiiii1    1
1    1Ki C1C1i1C1 iiiiI1    1
1    1ii  111i111iiii111    1
1    1iLiiiiii iiIiii1      1
1    1Liii 7 LiiiiiiI1      1
1    1111LiiiiiiiiIi11      1
1       111111LiiiiI1       1
1            11111111       1
1                           1
1                           1
1                           1
1                           1
11111111111111111111111111111
