11111111111111111111111111111111111111111111111111111111111111111
1                                                               1
1                                                               1
1                                                               1
1                      11111     11111                          1
1                      1  C1111111C  1                          1
1                     11    11 11 z  11                         1
1                     1C  C 1     9  C1                         1
1                     11m   1   1    11                         1
1                      144441 P 155551                          1
1                     11   l1   1    11                         1
1                     1C 8      1  C C1                         1
1                     11    11211  x 11                         1
1                      11C  11E11  C11                          1
1                       1111111111111                           1
1                                                               1
1                                                               1
1                                                               1
1                                                               1
1                                                               1
1                                                               1
1                                                               1
1                                                               1
1                                                               1
1                                                               1
1                                                               1
1                                                               1
1                                                               1
1                                                               1
1                                                               1
1                                                               1
1                                                               1
11111111111111111111111111111111111111111111111111111111111111111
