111111111
1EE1 !/.1
1EE1 BBB1
1GG1    1
1  1PCCC1
1  1 CCC1
1  1    1
1       1
111111111
