11111111111111111111
1P                 1
1                  1
1                  1
1        C         1
1                  1
1                  1
1     1111111      1
1     1WWWWW1      1
1     1WWWWW1      1
1     1111111      1
1                  1
1                  1
1                  1
1     1111111      1
1                  1
1                  1
111111             1
1EGGGG             1
11111111111111111111
