1111111111111111111111111111
1                          1
1                          1
1                          1
1                          1
1    acde                  1
1    fhjk                  1
1    lmno P                1
1    pqst                  1
1    uwxz                  1
1                          1
1                          1
1                        EC1
1111111111111111111111111111
